%s ago=před %s
%s used of %s %s %%=%s použito z %s (%s %%)
1 m=1 m
10 s=10 s
2 m=2 m
30 s=30 s
5 m=5 m
Abort background operation=Přerušit operaci na pozadí
Abort background process=Přerušit proces na pozadí
Active tunnels=Aktivní tunely
Activity=Aktivita
ago=před
Airflow=Tok vzduchu
Alert Message=Zpráva upozornění
Alerts=Upozornění
All Apps=Všechny aplikace
All VMs=Všechny virtuální stroje
Array Information=Informace o poli
Attention - operation continues in background=Pozor - operace pokračuje na pozadí
Battery charge=Kapacita baterie
BIOS dated=Datum BIOSu
Check free space=Zkontrolovat volné místo
checking=kontroluji
Click to toggle CPU chart=Klepnutím přepnete graf procesoru
Click to toggle details=Klepnutím přepnete detaily
Clock is synchronized using %s NTP servers, time offset is %s %s=Hodiny jsou synchronizovány pomocí %s NTP serverů, časový posun je %s %s
Clock is synchronized using %s PTP server, time offset is %s %s=Hodiny jsou synchronizovány pomocí %s PTP serveru, časový posun je %s %s
Clock is unsynchronized with no NTP servers=Hodiny nejsou synchronizovány, žádné NTP servery
Clock is unsynchronized with no PTP servers=Hodiny nejsou synchronizovány, žádné PTP servery
Clock is unsynchronized, free-running clock=Hodiny nejsou synchronizovány, volně běžící hodiny
Clock synchronized with %s NTP server=Hodiny synchronizovány s %s NTP serverem
Clock synchronized with %s NTP servers=Hodiny synchronizovány s %s NTP servery
Clone=Klonovat
Close Tile=Zavřít dlaždici
Completed=Hotovo
Containers=Kontejnery
Content Management=Správa obsahu
Counters info=Informace počítadel
Current operation %s on %s=Současná operace %s na **%s**
custom image=vlastní obraz
Data is invalid=Data jsou neplatná
default image=výchozí obraz
device warning=varování zařízení
device warnings=varování zařízení
Docker Containers=Kontejnery Dockeru
Docker folder=Složka Dockeru
Docker vdisk=Docker vDisk
Due in=Za
Edit VM after clone=Upravit VM po klonování
Elapsed time=Uplynulý čas
emulated=emulováno
Errors info=Informace o chybách
Estimated finish=Odhadované dokončení
failed device=selhávající zařízení
Fan count=Počet ventilátorů
Fan Information=Informace o ventilátorech
FAN=VENTILÁTOR
Finding %s error=Našla se: **%s** chyba
Finding %s errors=Našlo se: **%s** chyb
Flash device=Flash zařízení
Free=Volné
FS Native Snapshot=Nativní snapshot FS
General info=Obecné informace
Go to CPU pinning settings=Přejít na nastavení připnutí procesorů
Go to date and time settings=Přejít na nastavení data a času
Go to disk settings=Přejít na nastavení disku
Go to Docker settings=Přejít na nastavení Dockeru
Go to fan settings=Přejít na nastavení ventilátorů
Go to identification settings=Přejít na nastavení identifikace
Go to network settings=Přejít na nastavení sítě
Go to scheduler settings=Přejít na nastavení plánovače
Go to Share settings=Přejít na nastavení sdílení
Go to UPS settings=Přejít na nastavení UPS
Go to User settings=Přejít na nastavení uživatelů
Go to VM settings=Přejít na nastavení virtuálních strojů
Go to VPN settings=Přejít na nastavení VPN
grandmaster=grandmaster
Handshake=Vyjednání
has=má
healthy=zdravý
heat warning=varování teploty
heat warnings=varování přehřátí
Hide details=Skrýt detaily
in progress=probíhá
Inactive tunnels=Neaktivní tunely
inactive=neaktivní
Inbound=Příchozí
Information=Informace
Interface Information=Informace o rozhraní
invalid device=Neplatné zařízení
invalid devices=Neplatná zařízení
invalid=neplatné
Last check completed on %s=Poslední kontrola dokončena **%s**
Last check incomplete on %s=Poslední kontrola nedokončena **%s**
Last checked on %s=Poslední kontrola dne **%s**
Legend=Legenda
Lock sortable items=Zamknout položky k řazení
Log filesystem=Souborový systém logu
master=master
Maximum size=Maximální velikost
Memory dump=Výpis paměti
Memory Utilization=Využití paměti
Mode of operation=Provozní režim
Motherboard Information=Informace o základní desce
Network traffic=Síťový provoz
New VM=Nová VM
Next check scheduled on %s=Další kontrola naplánována na **%s**
No docker containers defined=Nejsou definovány žádné Docker kontejnery
No running docker containers=Nejsou spuštěny žádné Docker kontejnery
No running virtual machines=Nejsou spuštěny žádné virtuální stroje
No shares present=Nejsou přítomny žádné sdílené složky
No virtual machines defined=Nejsou definovány žádné virtuální stroje
No VMs running=Nejsou spuštěny žádné VM
Nominal power=Jmenovitý výkon
not received=neobdrženo
Notices=Oznámení
Notifications=Upozornění
Only PNG images are allowed=Povoleny jsou pouze obrázky PNG.
Outbound=Odchozí
Output voltage=Výstupní napětí
Overall Load=Celkové zatížení
Overwrite=Přepsat
Parity disk not present=Paritní disk není přítomen
Parity disks not present=Paritní disky nejsou přítomny
Parity has not been checked yet=Parita ještě nebyla zkontrolována
Parity Information=Informace o paritě
Parity is degraded=Parita je narušena
Percent of total used memory=Procento celkově využité paměti
Percent usage of Docker folder=Využití složky Docker v procentech
Percent usage of Docker vdisk=Využití Docker vdisk v procentech
Percent usage of flash usb device=Využití USB flash zařízení v procentech
Percent usage of LOG file system=Využití souborového systému LOG v procentech
Pool=Pool
Popup Blocked=Vyskakovací okno zablokováno.
Power Status=Stav napájení
Power=Napájení
Processor Information=Informace o procesoru
Put system to sleep=Uspat systém
RAM usage=Využití RAM
Reboot the system=Restartovat systém
Receive counters=Počítadla příjmu
Received packets=Přijaté pakety
Runtime left=Zbývající doba běhu
RX=RX
Scheduled parity check is disabled=Plánovaná kontrola parity je zakázána
Select Case Model=Vyber model skříně
Select time frame=Vyber časové období
Services=Služby
Share count %s with %s cache only and %s encrypted=%s sdílení z toho %s pouze v mezipaměti a %s šifrované
Share count %s with %s public SMB and %s public NFS=Počet sdílení: %s z toho %s veřejné SMB a %s veřejné NFS
Shares Information=Informace o sdílení
Show details=Zobrazit podrobnosti
Show Information=Zobrazit informace
ShowHide All Content=Zobrazit/Skrýt všechen obsah
ShowHide Content=Zobrazit/Skrýt obsah
Shutdown the system=Vypnout systém
SMART error=Chyba SMART
SMART errors=Chyby SMART
SMART health-check failed=SMART kontrola selhala
SMART=SMART
sn=s.č.
Snapshot Name=Název snapshotu
Snapshot=Snapshot
Start Cloned VM=Spustit klonovanou VM
Start the array=Spustit pole
Started only=Spuštěno pouze
Stop the array=Zastavit pole
synching=synchronizuji
Temp=Teplota
This may leave an unknown state=Toto může zanechat neznámý stav
This will put the system to sleep=Tímto uspíte systém
This will reboot the system=Tímto restartujete systém
This will shutdown the system=Tímto vypnete systém
This will start the array=Tímto spustíte pole
This will stop the array=Tímto vypnete pole
Tile Management=Správa dlaždic
Transmit counters=Počítadla přenesených
Transmitted packets=Přenesené pakety
TX=TX
Unassigned Devices=Nepřiřazená zařízení
Unchecked will use QEMU External Snapshot=Pokud není zaškrtnuto, použije se externí snapshot QEMU
Unlock sortable items=Odemknout položky k řazení
UPS Load=Zatížení UPS
UPS Model=Model UPS
UPS status=Stav UPS
Usable size=Využitelná velikost
User count %s with %s unprotected=%s uživatelů z toho %s nechráněno
Users Information=Informace o uživatelích
utilization warning=Upozornění na využití
utilization warnings=Upozornění na využití
View Running Processes=Zobrazit běžící procesy
Virtual Machines Usage=Využití virtuálních strojů
Virtual Machines=Virtuální stroje
VM Being Cloned=VM se duplikuje
VM Clone=Duplikovaná VM
VM Name=Název VM
VPN Connections=VPN připojení
W=W
Warnings=Varování
ZFS=ZFS
