Cancel=Zrušit

; My PSAs / banners
Happy New Year=Šťastný nový rok
Happy Holidays from Andrew, Tracey, and family=Krásné svátky přejí Andrew, Tracey a rodina
Please Enjoy Responsibly=Užívejte zodpovědně
Popup Blocked CA requires popups to be enabled under certain circumstances You must white list your server within your browser to allow popups=Vyskakovací okno bylo zablokováno. Community Applications vyžaduje za určitých podmínek povolení vyskakovacích oken. Přidejte svůj server na seznam povolených ve vašem prohlížeči.
Docker Service Not Enabled - Only Plugins Available To Be Installed Or Managed=Docker služba není povolena – k dispozici jsou pouze pluginy k instalaci nebo správě
Docker system failed to start - Only Plugins Available To Be Installed Or Managed=Systém Docker se nepodařilo spustit – k dispozici jsou pouze pluginy k instalaci nebo správě
Array not started - Only Plugins Available To Be Installed Or Managed=Pole není spuštěné – k dispozici jsou pouze pluginy k instalaci nebo správě
Community Applications works best when cookies are enabled in your browser Certain features may not be available=Community Applications funguje nejlépe, pokud jsou v prohlížeči povoleny cookies. Některé funkce nemusí být dostupné.
Backup Server Active Some icons may not appear, and plugin installations may be affected=Záložní server aktivní. Některé ikony se nemusí zobrazit a instalace pluginů může být ovlivněna.
Debugging enabled This significantly increases the memory used by your browser=Ladění je aktivní – výrazně to zvyšuje spotřebu paměti vašeho prohlížeče
Browser translation detected Display issues may result=Zjištěno překládání prohlížečem – může způsobit problémy se zobrazením
Action Centre Enabled=Centrum akcí je aktivní
Deprecated OS version No further updates to Community Applications will be issued for this OS version=Zastaralá verze operačního systému. Pro tuto verzi nebudou vydávány další aktualizace Community Applications.

; Sorting Options
Sort By=Seřadit podle
Name Ascending=Název vzestupně
Name Descending=Název sestupně
Downloads=Stažení
Date Added=Datum přidání
Number Of Apps=Počet aplikací

; Initial disclaimer translations
Disclaimer=Vyloučení odpovědnosti
All applications listed here are 3rd party additions to Unraid Neither the authors of Community Applications nor Limetech make any warranty as to the suitability of any application listed here=Všechny zde uvedené aplikace jsou doplňky třetích stran pro Unraid. Autoři Community Applications ani Limetech nezaručují vhodnost žádné z uvedených aplikací.
Every attempt is made to ensure that only safe and compatible applications are present=Vynakládá se maximální úsilí, aby byly k dispozici pouze bezpečné a kompatibilní aplikace.
Application Policy=Zásady aplikace
I Understand=Rozumím
Installations of apps disabled You must accept the warning to be able to install applications=Instalace aplikací je zakázána. Pro možnost instalace musíte přijmout varování.
Click here=Klikněte sem
%s Results Per Page=%s výsledků na stránku
Results Per Page: %s=Výsledků na stránku: %s

; Plugin Disclaimer
Community Applications contains both docker containers and plugin applications Plugins are designed for OS enhancements, and run with full privileges on your system and are clearly identified within CA=Community Applications obsahuje jak dockerové kontejnery, tak pluginy. Pluginy slouží k rozšíření systému, běží s plnými oprávněními a jsou v CA jasně označeny.
Plugin Note=Poznámka k pluginu

; Multi Install
Install Plugin Applications=Nainstalovat pluginy
Select all on page=Vybrat vše na stránce
Install Application=Nainstalovat aplikaci
Install Applications=Nainstalovat aplikace
Update Application=
Update Applications=Aktualizovat aplikace
Are you sure you want to update %s applications=Opravdu chcete aktualizovat %s aplikací?
Are you sure you want to install %s docker and %s plugin applications=Opravdu chcete nainstalovat %1$s Docker kontejner(ů) a %2$s plugin(ů)?

; Searches
Search=Hledat
Click Here To Get More Results From DockerHub=Klikněte sem pro další výsledky z Docker Hub
No Matching Applications Found=Nebyly nalezeny žádné odpovídající aplikace

; Repository Related
%s removed as favourite repository=%s byl odebrán ze seznamu oblíbených repozitářů
%s set as favourite repository=%s byl přidán do seznamu oblíbených repozitářů
Click to remove favourite repository=Klikni pro odebrání repozitáře z oblíbených
Click to set %s as favourite repository=Klikni pro přidání %s mezi oblíbené repozitáře
Search for apps in repository=Hledat aplikace v repozitáři
No description present=Bez popisu
Go to the forum page=Přejít na stránku fóra
Go to the webpage=Přejít na webovou stránku
Go to reddit=Přejít na Reddit
Go to facebook=Přejít na Facebook
Go to discord=Přejít na Discord
Go to forum profile=Zobrazit profil na fóru
Show Profile=Zobrazit profil
SHOW MORE=ZOBRAZIT VÍCE
SHOW LESS=ZOBRAZIT MÉNĚ
Read more=Číst více
Total Applications=Celkem aplikací
Total Known Downloads=Celkový počet stažení
Total Docker Applications=Celkem Docker kontejnerů
Total Plugin Applications=Celkem pluginů
Total Languages=Celkem jazyků
Average Downloads Per App=Průměrné stažení na aplikaci
Web Page=Webová stránka
Forum=Fórum
Forum Profile=Profil na fóru
Profile=Profil
Facebook=Facebook
Reddit=Reddit
Twitter=Twitter
Discord=Discord
Search Apps=Hledat aplikace
Registry=Seznam zdrojů
Details=Podrobnosti
Added=Přidáno

; Install Plugin title of openbox
Install Plugin=Nainstalovat plugin
Update Plugin=Aktualizovat plugin

Requirements not met=Požadavky nesplněny
The requirements for this upgrade have not been met on your system=Požadavky pro tento upgrade nejsou ve tvém systému splněny
The sidebar for the app click info will list the details=Podrobnosti budou uvedeny v postranním panelu aplikace (klikni na Info)

BACK=ZPĚT

; Remove App from previously installed
Delete Template=Smazat šablonu
Yes, delete it=Ano, smazat

; Uninstall popup
Uninstall Application=Odinstalovat aplikaci
Yes uninstall it=Ano, odinstalovat

; Remove Private Application
Remove Private Application=Odstranit soukromou aplikaci
Yes, remove it=Ano, odstranit

; App Pinning
Click to pin this application=Klikni pro připnutí této aplikace
Click to unpin this application=Klikni pro odepnutí této aplikace
Pin App=Připnout aplikaci
Unpin App=Odepnout aplikaci

; Branch installations
Choose A Branch To Install=Vyberte větev k instalaci

; Multiple application installs
; no apps selected
Install Selected Applications=Nainstalovat vybrané aplikace

Yes, install it=Ano, nainstalovat

; Multi-install popup
Yes, install them=Ano, nainstalovat je

Cookies not enabled Plugins must be separately installed from docker applications=Cookies nejsou povolené. Pluginy musí být instalovány samostatně od dockerových aplikací.

Docker applications will be installed utilizing the most recently saved template with no user input on your part=Dockerové aplikace budou nainstalovány pomocí nejnověji uložené šablony bez potřeby vašeho zásahu.

Updating Support Links=Aktualizuji odkazy na podporu

Downloading docker icons=Stahuji ikony dockeru

Finished Installing If the DONE button did not appear, then you will need to click the red X in the top right corner=Instalace dokončena. Pokud se nezobrazil tlačítko HOTOVO, klikněte na červené X vpravo nahoře.


; error messages
An error occurred Could not find any %s Apps=Došlo k chybě. Nebyly nalezeny žádné %s aplikace.
Download of appfeed failed=Stahování appfeedu selhalo.
; the %s here refers to a function being called
Something really went wrong here=Zde se opravdu něco pokazilo.
Post the ENTIRE contents of this message in the Community Applications Support Thread=Zveřejněte CELÝ obsah této zprávy v diskuzním vlákně podpory Community Applications.
Unknown error happened Please post a screenshot in the support thread of the Statistics screen=Došlo k neznámé chybě. Prosím, vložte screenshot obrazovky Statistik do podpůrného vlákna.
This plugin has a duplicated name from another plugin %s This will impact your ability to install both plugins simultaneously=Tento plugin má duplicitní název jako jiný plugin %s. Toto ovlivní možnost instalace obou pluginů současně.
You have been logged out=Byli jste odhlášeni.
Fatal Flash Drive Error=Kritická chyba flash disku.
This usually means your flash drive is corrupted or has dropped offline The rest of the Unraid GUI will also be affected Post a new thread in the Unraid forums if this error continues=Obvykle to znamená, že váš flash disk je poškozený nebo offline. Zbytek Unraid GUI bude také ovlivněn. Pokud tato chyba přetrvává, založte nové vlákno na fóru Unraid.
Fatal Docker Image Error=Kritická chyba dockerového obrazu.
Your docker image or folder is either read-only or completely full Issues will result because of this You should create a new post in the Unraid forums and include your diagnostics=Váš dockerový obraz nebo složka je buď pouze pro čtení, nebo úplně zaplněná. Z toho mohou vzniknout problémy. Měli byste vytvořit nové vlákno na fóru Unraid a přiložit diagnostiku.
This template is set up to use a custom network You may have to adjust the network or IP address etc to match your system=Tato šablona je nastavena na použití vlastní sítě. Možná bude potřeba upravit síť nebo IP adresu atd., aby odpovídaly vašemu systému.
This template is set up to run as Privileged This is a possible security risk and usually does not need to be enabled Note that some applications require privileged in order to operate correctly=Tato šablona je nastavena k běhu s oprávněními Privileged. To může představovat bezpečnostní riziko a obvykle není potřeba povolovat. Některé aplikace však potřebují privilegovaný režim pro správný chod.
One or more ports used by this application are already in use by another service or app running on your server You will need to adjust the host ports accordingly on the template=Jeden nebo více portů používaných touto aplikací je již obsazen jinou službou nebo aplikací běžící na vašem serveru. Budete muset upravit porty hostitele v šabloně.
Not Enough Memory=Nedostatek paměti.
Community Applications and Unraid OS have a minimum required installed memory of 4G CA cannot run without those mimimums being met=Community Applications a Unraid OS vyžadují minimálně 4 GB RAM. CA nemůže běžet, pokud není tento požadavek splněn.
Run Anyways=Spustit přesto.
Memory Requirements not met Problems may result=Nesplněny požadavky na paměť. Mohou vzniknout problémy.
Installation already in progress=Instalace již probíhá.
Another plugin installation or update is already in progress and this one cannot start Wait until the current installation or update is completed and try again=Jiná instalace nebo aktualizace pluginu již probíhá a tato nemůže začít. Počkejte na dokončení současné instalace nebo aktualizace a zkuste to znovu.
Clear Flag=Vymazat příznak.
%s is incompatible with your OS version Please update the OS to proceed=%s není kompatibilní s vaší verzí OS. Pro pokračování aktualizujte OS.
%s is incompatible with your OS version Either uninstall %s or update the OS=%s není kompatibilní s vaší verzí OS. Buď odinstalujte %s, nebo aktualizujte OS.
Browser failed to communicate with Unraid Server=Prohlížeč se nepodařilo spojit se serverem Unraid.
For unknown reasons, your browser was unable to communicate with Community Applications running on your server=Z neznámých důvodů se váš prohlížeč nedokázal spojit s Community Applications běžícím na vašem serveru.
Additional information may be within Tools, PHPSettings - View Log=Doplňující informace mohou být v Nástrojích, PHPSettings – Zobrazit protokol.
Attempt to Fix Via Reload Page=Pokuste se opravit obnovením stránky.
External Link=Externí odkaz.
Clicking OK will take you to a 3rd party website not associated with Limetech=Kliknutím na OK budete přesměrováni na web třetí strany, který není spojen s Limetech.


; CA Sections Keep the length reasonable
Home=Domů
Installed Apps=Nainstalované aplikace
Previous Apps=Předchozí nainstalované aplikace
Pinned Apps=Připnuté aplikace
Favourite Repo=Oblíbené repozitáře
Action Centre=Centrum akcí
Recently Added=Nedávno přidané
Random Apps=Náhodné aplikace
Top New Installs=Nejčastěji nové instalace
Top Trending Apps=Nejtrendovější aplikace
Spotlight Apps=Doporučené aplikace
All Apps=Všechny aplikace
Statistics=Statistiky
Credits=Zásluhy
Support=Podpora
VERSION=VERZE
Change Log=Změny ve verzích
Debugging=Ladění

; Credits
Development=Vývoj
Additional Contributions=Další přispěvatelé
GUI Layout Design=Návrh rozvržení GUI
Application Feed=Zdroj aplikací
Additional Testing=Dodatečné testování
Moderation=Moderace
Additional Libraries=Dodatečné knihovny
Copyright=Autorská práva
Translation=Překlad

; Statistics page

unknown=Neznámý
Last Change To Application Feed=Poslední změna ve zdroji aplikací
Docker Applications=Docker kontejnery
Plugin Applications=Pluginy
Templates=Šablony
Official Containers=Oficiální kontejnery
Repositories=Repozitáře
Private Docker Applications=Soukromé Docker aplikace
Invalid Templates=Neplatné šablony
Template Errors=Chyby šablon
Blacklisted Apps=Zablokované aplikace
Incompatible Applications=Nekompatibilní aplikace
Deprecated Applications=Zastaralé aplikace
Moderation Entries=Záznamy moderace
Primary Server=Primární server
Backup Server=Záložní server
Installs not allowed from this page=Instalace z této stránky nejsou povoleny

; Statistics Popup
No invalid templates found=Nebyly nalezeny žádné neplatné šablony
These templates are invalid and the application they are referring to is unknown=Tyto šablony jsou neplatné a aplikace, na kterou odkazují, není známa
No templates were automatically fixed=Žádná šablona nebyla automaticky opravena
All of these errors found have been fixed automatically=Všechny nalezené chyby byly automaticky opraveny
Note that many of these errors can be avoided by following the directions=Většině těchto chyb lze předejít dodržováním pokynů
HERE=ZDE
The following plugins have duplicated filenames and are not able to be installed simultaneously=Následující pluginy mají duplicitní názvy souborů a nelze je nainstalovat současně
The following docker applications refer to the same docker repository but may have subtle changes in the template to warrant this=Následující Docker aplikace odkazují na stejný repozitář, ale mohou mít drobné změny v šabloně, které toto ospravedlňují
If any of these entries are incorrect then contact the moderators of CA to discuss=Pokud je některý z těchto záznamů nesprávný, kontaktuj moderátory CA
Global Repository Comments=Globální komentáře k repozitáři
Applied to all applications=Platí pro všechny aplikace
Individual Application Moderation=Individuální moderace aplikace

; Misc
Community Applications Changelog=Změny ve verzích Community Applications

Each month we highlight some of the amazing work from our community=Každý měsíc vyzdvihujeme některé skvělé příspěvky naší komunity
Check out these newly added applications from our awesome community=Podívej se na tyto nově přidané aplikace od naší skvělé komunity
Check out these up and coming apps=Podívej se na tyto nové a perspektivní aplikace
These apps have the highest percentage of new installs=Tyto aplikace mají nejvyšší podíl nových instalací
An assortment of randomly chosen apps=Náhodně vybrané aplikace
Featured Applications=Vybrané aplikace

; Categories try not to be excessively long This is displayed on the left of CA screen

Backup=Zálohování
Cloud=Cloud
Crypto Currency=Kryptoměna
Downloaders=Stahovače
Drivers=Ovladače
Game Servers=Herní servery
Home Automation=Domácí automatizace
Media Applications=Mediální aplikace
Books=Knihy
Music=Hudba
Photos=Fotky
Video=Video
Other=Ostatní
Media Servers=Mediální servery
Network Services=Síťové služby
DNS=DNS
FTP=FTP
Management=Správa
Messenger=Komunikace
Proxy=Proxy
VOIP=VOIP
VPN=VPN
Web=Web
Privacy=Soukromí
Productivity=Produktivita
Security=Bezpečnost
Spotlight=Doporučeno
Tools Utilities=Nástroje a pomůcky
System=Systém
Themes=Motivy
Utilities=Nástroje
Private Apps=Soukromé aplikace
Uncategorized=Bez kategorie

; Categories displayed within a popup or on the card.  Where an entry exists after the "=" it is not translated, but rather how it should look
GameServers=Herní servery
HomeAutomation=Domácí automatizace
MediaApp=Mediální aplikace
MediaAppBooks=Mediální aplikace:Knihy
MediaAppMusic=Mediální aplikace:Hudba
MediaAppPhotos=Mediální aplikace:Fotky
MediaAppVideo=Mediální aplikace:Video
MediaAppOther=Mediální aplikace:Jiné
MediaServer=Mediální server
MediaServerBooks=Mediální server:Knihy
MediaServerMusic=Mediální server:Hudba
MediaServerPhotos=Mediální server:Fotky
MediaServerVideo=Mediální server:Video
MediaServerOther=Mediální server:Jiné
Network=Síť
NetworkDNS=Síť:DNS
NetworkFTP=Síť:FTP
NetworkManagement=Síť:Správa
NetworkProxy=Síť:Proxy
NetworkVOIP=Síť:VOIP
NetworkVPN=Síť:VPN
NetworkPrivacy=Síť:Soukromí
NetworkWeb=Síť:Web
NetworkOther=Síť:Jiné
ToolsSystem=Nástroje:Systém
ToolsThemes=Nástroje:Motivy
ToolsUtilities=Nástroje:Pomůcky
OtherUncategorized=Jiné:Bez kategorie
and %s more=a %s více

; App Popup Related
This application template has been blacklisted=Tato šablona aplikace byla zablokována
This application template has been deprecated=Tato šablona aplikace je zastaralá
This application has additional requirements=Tato aplikace má dodatečné požadavky
Additional Requirements=Další požadavky
Donate To Author=Darovat autorovi
Donate To Maintainer=Darovat správci
CLOSE=ZAVŘÍT
Author=Autor
Maintainer=Správce
DockerHub=Docker Hub
Application Template=Šablona aplikace
DockerHub Stars=Docker Hub hodnocení
Added to CA=Přidáno do CA
Date Updated=Datum aktualizace
Current Version=Aktuální verze
Min OS=Minimální OS
Max OS=Maximální OS
Total Downloads=Celkem stažení
Popularity=Oblíbenost
Licence=Licence
Ranked #%s=Hodnocení #%s
Trending %s=Trend %s
As of %s=K datu %s
Play Video=Spustit video
Play Video %s=Spustit video %s
This application is not compatible with your version of Unraid=Tato aplikace není kompatibilní s tvojí verzí Unraid
Another browser tab or device has updated the displayed templates Some actions are not available=Jiná karta prohlížeče nebo zařízení aktualizovalo šablony. Některé akce nejsou dostupné
WebUI=WebUI
Reinstall=Přeinstalovat
Reinstall From Previous Apps=Znovu nainstalovat z předchozích aplikací
Install=Nainstalovat
Uninstall=Odinstalovat
Project=Projekt
Read Me First=Nejprve si přečtěte
Install second instance=Nainstalovat druhou instanci
Install Using The Templates Default Tag=Nainstalovat pomocí výchozí šablony
Moderator Comments=Komentáře moderátora
Note not all authors keep up to date on change logs=Upozornění: Ne všichni autoři udržují záznamy změn aktuální
Note not all maintainers keep up to date on change logs=Upozornění: Ne všichni správci udržují záznamy změn aktuální
Last Update=Poslední aktualizace
Note All statistics are only gathered every 30 days=Poznámka: Všechny statistiky jsou shromažďovány každých 30 dní
Donate=Darovat
Currently Installed Version=Aktuálně nainstalovaná verze
Install The Update=Instalovat aktualizaci
Latest Version=Nejnovější verze
Multi Language Support=Podpora více jazyků
Support Forum=Fórum podpory
More than %s=Více než %s
Remove from Previous Apps=Odstranit z předchozích aplikací
Remove=Odstranit
See All Apps=Zobrazit všechny aplikace
Favourite=Oblíbené
Application Type=Typ aplikace

; Graphs
Trend Per Month=Trend za měsíc
Downloads Per Month=Stažení za měsíc

; Multi install script
Installing docker applications %s=Instaluji Docker aplikaci %s
Starting %s=Spouštím %s
%s failed to start You should install it by itself to fix the errors=%s se nepodařilo spustit. Zkus ji nainstalovat samostatně, abys opravil chyby
Setting installed applications to autostart=Nastavuji automatické spouštění pro nainstalované aplikace
Docker Application Installation finished=Instalace Docker aplikace dokončena

; Application Cards
Actions=Akce
Pending=Čekající
This application is a driver plugin= Tato aplikace je ovladač (plugin)
This is a language pack= Toto je jazykový balíček
This application is a docker container= Tato aplikace je dockerový kontejner
This application is a plugin= Tato aplikace je plugin
This is a spotlight application= Toto je spotlight aplikace
This is your favourite repository= Toto je vaše oblíbené úložiště
This application is from your favourite repository= Tato aplikace je z vašeho oblíbeného úložiště
This application is pinned for later viewing= Tato aplikace je připnutá pro pozdější zobrazení
Private Application= Soukromá aplikace
Remove Application From List= Odebrat aplikaci ze seznamu
Check off to select multiple reinstalls= Zaškrtněte pro výběr více reinstalací
Go to the plugin settings= Přejít do nastavení pluginu
Click to reinstall the application using default values= Klikněte pro přeinstalaci aplikace s výchozími hodnotami
Click to edit the application values= Klikněte pro úpravu hodnot aplikace
Click to reinstall= Klikněte pro přeinstalaci
Click to install= Klikněte pro instalaci
Click to go to the WebUI= Klikněte pro přechod na WebUI
This application template has been deprecated= Tento šablonový soubor aplikace je zastaralý
This application template has been blacklisted= Tento šablonový soubor aplikace je na blacklistu
Click info to see the notes regarding this application= Klikněte na info pro zobrazení poznámek k této aplikaci
This application has additional requirements= Tato aplikace má další požadavky
BETA= BETA
INSTALLED= NAINSTALOVÁNO
OFFICIAL= OFICIÁLNÍ
UPDATED= AKTUALIZOVÁNO
This is an official container= Toto je oficiální kontejner
Digitally Signed= Digitálně podepsáno
This container is digitally signed= Tento kontejner je digitálně podepsán
Docker Hub= Docker Hub
NOTE You must visit the dockerHub page to gather the information required to install correctly= POZNÁMKA: Musíte navštívit stránku Docker Hub, abyste získali informace potřebné pro správnou instalaci
Show CA templates= Zobrazit CA šablony
Deprecated= Zastaralé
Incompatible= Nekompatibilní
Blacklisted= Na blacklistu
Template Exists= Šablona existuje
Template already exists in Apps= Šablona již existuje v aplikacích
; eg: LinuxServer Repository
%s Repository=%s repozitář
; eg: Squid's Repository
%s's Repository=Repozitář uživatele %s

Info=Informace
Attention=Pozor
Repository=Repozitář
Why we picked it=Proč jsme to vybrali
Application Spotlight %s=Zvýrazněná aplikace: %s
Unraid Staff=Unraid tým

; Page Navigation
Displaying %s - %s of %s=Zobrazeno %1$s – %2$s z %3$s

Updating Content=Aktualizuji obsah
Language=Jazyk
Switch to this language=Přepnout na tento jazyk
Country Code=Kód země
Install Language Pack=Nainstalovat jazykový balíček
Remove Language Pack=Odebrat jazykový balíček
Update Language Pack=Aktualizovat jazykový balíček
Installed Version=Nainstalovaná verze
A note about translations=Poznámka k překladům
Click here to view the language changelog=Klikni zde pro zobrazení historie změn překladu
View Missing Translations=Zobrazit chybějící překlady

; Update Checks
Check For Updates=Zkontrolovat aktualizace
Check for updates already running=Kontrola aktualizací již probíhá
Checking for docker container updates=Kontrola aktualizací Docker kontejnerů
Checking for plugin updates=Kontrola aktualizací pluginů
Checking for language updates=Kontrola aktualizací jazykových balíčků
Checking %s=Kontroluje se %s

; dockerHub conversions
Determine configuration=Zjistit konfiguraci
Would you like CA to attempt to determine any applicable paths, ports, and variables for the template This will entail performing a test installation of the container It will be automatically deleted after processing The container will not be started=Chceš, aby se CA pokusil automaticky zjistit odpovídající cesty, porty a proměnné pro tuto šablonu? Bude provedena testovací instalace kontejneru, která bude po zpracování automaticky odstraněna. Kontejner nebude spuštěn.
An error occurred - Could not determine configuration=Došlo k chybě – konfiguraci se nepodařilo zjistit

; WebGui
Click Install to download and install the Community Applications plugin=Klikni na **Instalovat**, aby se stáhl a nainstaloval plugin **Community Applications**

; Note: April 29, 2023 - 114 missing translations